F 20,1,1

NO ./textures/barrel.xpm

    EA ./textures/wood.xpm
WE ./textures/redbrick.xpm 

C       2 , 3 ,   3  

SO ./textures/greystone.xpm

111111111111111111
100000100000000001
100010000000000001
100000000000000001
10000000N000000001
100000000000000001
100000000000000001
100000000000000001
111111111111111111
