
       
       
F 20,1,1

NO ./textures/barrel.xpm

    EA ./textures/wood.xpm
WE ./textures/redbrick.xpm 

C       2 , 3 ,   3  

SO ./textures/greystone.xpm
11111111111
1N011111111
10000000001
11111111111
11111111111