NO ./textures/Grass_04-128x128.xpm
SO ./textures/Grass_13-128x128.xpm
WE ./textures/Bricks_02-128x128.xpm
EA ./textures/Tile_01-128x128.xpm

F 192,192,192
C 135,206,235

1111111111111111111
1000000000000000001
1000000000000000001
1000000000000000001
1000000000000000001
10000000000000N0001
1000000000000000001
1000000000000000001
1111111111111111111